G00000000000000000000
011111111011111111110
000000001000000000010
011111101111111101010
000000000000000001010
011111111111110001010
000000000000010001010
011111101111010001010
010000101000010001010
010111101011110001010
010100000000000001010
010101111111111101010
010101000000000001010
010101011111111101010
010101010000000001010
010101010111111101010
010101010100000001010
010101010101111101010
010000000001000001000
01111111111111111111P
