G000000001000000
0111111010111110
0100001010000010
0101111011111010
0101000000001010
0101011111101010
0101010000101010
0101010110101010
0100010100101010
0111010101101010
0000010100001010
0111110111111010
0000000000000010
0111111111111110
00000000000000P0
