G00000000000000
011111111111111
000000000000001
011111111111111
000000000000001
011111111111111
000000000000001
011111111111111
000000000000001
011111111111111
000000000000001
011111111111111
000000000000001
011111111111111
00000000000011P